# Datatypes (KEYWORD1)

SX	KEYWORD1
SXCommand	KEYWORD1

# Methods and Functions (KEYWORD2)

get	KEYWORD2
init	KEYWORD2
isr	KEYWORD2
set	KEYWORD2
get	KEYWORD2
decode	KEYWORD2


# Constants (LITERAL1)

SX_CLK	LITERAL1
SX_DATA	LITERAL1
MAX_CHANNEL_NUMBER	LITERAL1
SCOPE	LITERAL1
SYNC	LITERAL1
ADDR	LITERAL1
DATA	LITERAL1
MAX_DATACOUNT	LITERAL1
MAX_DATABITCOUNT	LITERAL1
MAX_CHANNEL_NUMBER	LITERAL1